111111
101101
1CC1E1
1BC1P1
111111