111111
101111
10p011
10E001
1B01P1
111111