1111111111111111111111111111111111
1E00000000000000000000000000000001
101001010010000010100100P000010101
1C10010010101010001001000000010101
10C00CC0000000000B0000000000000001
1111111111111111111111111111111111